###########
#\\\\\\\S\#
#\\\\\\\\\#
#\\\\+\\\\#
#\\\\O\\\\#
#\O\\\\\\\#
###########

# = barrier
\ = open
+ = start
s = shop
O = orc